11111111111111111
11110000000111111
11100C00000011111
11100000000001111
11100000000001111
11000000000001111
100M0000000000011
10000000000000001
10000000000P00001
110000M0000000001
11100000000000001
1110000000000C001
111000C0000000001
11100000000000011
11100000000001111
11100011110001111
1110001111M001111
1110M011110001111
11100011110001111
111000111100E1111
11111111111111111