1111111111111111111111111111111111
1P000000000000C000000C0000000000E1
1000010100100000101001000000010101
1000010010101010001001000000010101
101000000C00C00000000000M0000000C1
1010000000000000000000000000000001
1111111111111111111111111111111111